T.T.T.T.T.T.T.T.T.T.
.B...B...B...B...B..
R.....R.....R.....R.
..B.........B.....B.
T.T.T.T.T.T.T.T.T.T.
.......Y............
.B...B...B...B...B..
R.....R.....R.....R.
..B.........B.....B.
T.T.T.T.T.T.T.T.T.T.