.B..R..B..R..B..R..B
T...T...T...T...T...
B..B..B..B..B..B..B.
.T...T...T...T...T..
..R..B..R..B..R..B..
Y...................
..B..R..B..R..B..R..
.T...T...T...T...T..
B..B..B..B..B..B..B.
...T...T...T...T...