MMMMM.BBBBB.MMMMM
M...M.B...B.M...M
M.B.M.BBB.B.M.B.M
M...M.....M.M...M
MBB.........BBB.M
..Y....R.R.....R.
MBB.........BBB.M
M...M.....M.M...M
M.B.M.BBB.B.M.B.M
M...M.B...B.M...M