..T.....B.....T.....
.......BBB..........
..M.............M...
.....B.....B........
............B.......
..Y.................
.....BBB............
..R.............R...
.T.....B.....T......
....................