.B...B...B...B...B..
T.T.T.T.T.T.T.T.T.T.
....................
..B...B...B...B...B.
M.M.M.M...M.M.M.M.M.
.........Y..........
.B...B...B...B...B..
....................
..R....R....R....R..
.T.T.T.T.T.T.T.T.T.T