.B..M...B..M...B..M.
T.....T.....T.....T.
..B.....BBB.....B...
.T.....T.....T.....T
.....R.......R......
Y...................
.....R.......R......
..B.....BBB.....B...
T.....T.....T.....T.
.B..M...B..M...B..M.