TT......B......TT...
.T..T.......T..T....
..B...BBB...BBB...B.
.T....B.B...B.B....T
.......Y............
MM....R...R...R....MM
..B.............B...
.T..T.......T..T....
..R.......R.......R.
TT......B......TT...