MMMM............MMMM
...B............B...
..B.B..........B.B..
...B............B...
MMMM............MMMM
........Y...........
.....BBB.BBB........
..R.......R.....R...
.TT.....T..T.....TT.
....................