M.M.M.M.M.M.M.M.M.M
.B.R.B.R.B.R.B.R.B.
M.T.M.T.M.M.M.T.M.M
B..B..R..B..R..B..B
M.M.M.M.Y.M.M.M.M.M
.R.B.R.B.R.B.R.B.R.
M.T.M.M.M.M.M.M.T.M
B..R..B..R..B..R..B
M.M.M.M.M.M.M.M.M.M
.T.B.T.B.T.B.T.B.T.